10 x 20
*************O******
*   R *     *+*    *
*     + *     *    *
*       H          *
*  R +             *
*     *       +*   *
*   * R *      *   O
***      **        *
*****              *
********************